--------------------------------
--------------------------------
--------------------------------
--------------------------------
--------------------------------
--------------------------------
--------*************-----------
-------**************-----------
-------***************----------
-------****************---------
------******************--------
---**********************-------
--************************------
********************************
********************************
********************************
********************************
================================
--------------------------------
--------------------------------
--------------------------------
--------------------------------
**********--------------********
**************---------*********
***************--------*********
****************-------*********
******************-----*********
*****************----***********
*****************-----**********
*****************------*********
*****************-----**********
*****************------*********
*****************------*********
********************************
********************************
================================
********************************
----------------------------****
-----------------------------***
**----------------------------**
**----------------------------**
**--------********------------**
**------***********-----------**
**************----------------**
************-----------------***
************-----------------***
*********------------------*****
-------------------------*******
---------------------***********
-------------------*************
----------------****************
********************************
********************************
================================
--------------------------------
--------------------------------
--------------------------------
--------------------------------
----------**------**------------
--------****------**------------
-------*****------***-----------
-------*****------***-----------
-------*****------****----------
-------*****------*****---------
------******------******--------
---********-------**************
--********--------**************
*********---------**************
*********---------**************
**************----**************
*************----***************
================================
--------------------------------
-------------------------------*
-------------------------------*
--------------------------------
--------------------------------
--------------------------------
--------------------------------
--------------------------------
-------------------------------*
-------------------------------*
--------------------************
--------------------************
-------------------*************
-------------------*************
-----------------***************
-----------**------*************
********************************
================================
----------------------**********
-------------------------*******
---------------------------*****
---------------------------*****
-----------------------*********
----------------------**********
----------------------**********
-----------------------*********
----------------------**********
----------------------**********
----------------------**********
-----------------------*********
-----------------------*********
------------------------********
------------------------********
-------------------------*******
-------------------------*******
================================
--------------------------------
-------------------------------*
------------------------------**
---------------------------*****
-----------------------------***
------------------------------**
-----------------------------***
*-----------------------------**
**-----------------------------*
***-----------------------------
***-----------------------------
**------------------------------
*-----------------------------**
**--------------------------****
***------------------------*****
********************************
********************************
================================
-----------****-----------------
**---------***------------------
*----------**------*------------
*-----------**-----***----------
*---**------*------*------------
*--****-------------------------
*---**--------------------------
*-----------**----*-------------
**----------**---***------------
***---------------**------------
***----**-------*---------------
**-----**-------**--------------
*-------**------***-------------
**------**-------***------------
***-----**------****-----------*
********************************
********************************
================================
--------------***---------------
----------------*---------------
---------****--------***********
--------******------************
--------*******-----************
--------********-------*********
-------**********-----**********
-------**********------***-----*
-------************-----*------*
-------************-----*****--*
-----***************-----***---*
--*******************----------*
-*********************---------*
********************************
********************************
********************************
********************************
================================
********************************
********************************
------------------------********
---------------------****---****
-------------------***------****
-------------------***----------
-------------------**-----------
--------------------------------
--------------------------------
--------------****-------*******
-------------******------*******
---------------****------*******
-------------------------*******
-----------------------*********
********************************
********************************
********************************
================================
