--------------------------------
--------------------------------
--------------------------------
--------------------------------
--------------------------------
--------------------------------
--------*************-----------
-------**************-----------
-------***************----------
-------****************---------
------******************--------
---**********************-------
--************************------
********************************
********************************
********************************
********************************
================================
--------------------------------
--------------------------------
--------------------------------
--------------------------------
**********--------------********
**************---------*********
***************--------*********
****************-------*********
******************-----*********
*****************----***********
*****************-----**********
*****************------*********
*****************-----**********
*****************------*********
*****************------*********
********************************
********************************
================================
********************************
----------------------------****
-----------------------------***
**----------------------------**
**----------------------------**
**--------********------------**
**------***********-----------**
**************----------------**
************-----------------***
************-----------------***
*********------------------*****
-------------------------*******
---------------------***********
-------------------*************
-------------------------*******
*************------------*******
********************************
================================
--------------------------------
--------------------------------
--------------------------------
--------------------------------
----------**------**------------
--------****------**------------
-------*****------***-----------
-------*****------***-----------
-------*****------****----------
-------*****------*****---------
------******------******--------
---********-------**************
--********--------**************
*********---------**************
*********---------**************
*************-----**************
*************----***************
================================
--------------------------------
-**----------------------------*
-----**---------*****---------*
------****--***-----------------
-------------------------***----
------------**------------------
-----*------**------------------
-----*--------------------------
-----*-------------------------*
-**----------------------------*
------*----**-------************
------*-------------************
-------------------*************
---***-------------*************
-----------------***************
-----------**------*************
********************************
================================
----------------------**********
-------------------------*******
---------------------------*****
---------------------------*****
-----------------------*********
----------------------**********
----------------------**********
-----------------------*********
----------------------**********
----------------------**********
----------------------**********
-----------------------*********
-----------------------*********
------------------------********
------------------------********
-------------------------*******
-------------------------*******
================================
--------------------------------
--------------------------------
--------------------------------
--------------------------------
--------------------------------
--------------------------------
--------------------------------
--------------------------------
--------------------------------
--------------------------------
--------------------------------
--------------------------------
--------------------------------
--------------------------------
--------------------------------
--------------------------------
********************************
================================
-----------*--------*-----------
-------**-----**---------*------
----**--------**------**-*------
---------------------*----------
--*------**----**----*-***------
---------*----*-----------------
--*----**--------*----*---------
-----*----***-*-------***-------
--*---*-------------*------*----
--*---**--*----*----*-*----**---
--*----*------*-------*----*----
------*-------*-----*-----------
----**--***---------*----**-----
------*--------*---------***----
------*--*----**---*-------*----
------*--*----------------------
***----*------------------------
================================
